111111111111111
101010101010101
101010101010100
100000000000101
101111111111101
120000000000001
111111111111111
